5:9
LLLFFFFMM
LLLLFFMMM
LLLLLLLLM
LLLFFFFFL
LLLLFFLLM
---------
AGR.....T
GGR......
RRRE..TWW
..E...WOO
...E..WOS